40 22
3 2
1 1 1 1 1 1 1 1 1 1 1 1 1 1 1 1 1 1 1 1 1 1 1 1 1 1 1 1 1 1 1 1 1 1 1 1 1 1 1 1
1 2 2 2 2 2 4 2 2 3 2 4 2 2 2 2 2 4 2 4 2 2 2 2 2 2 2 6 2 2 2 4 2 2 2 2 2 2 2 1
1 2 4 6 4 2 2 2 2 2 2 2 2 2 2 2 2 2 2 2 4 3 2 2 4 2 2 6 2 2 2 2 2 2 2 2 2 2 2 1
1 2 2 2 2 2 7 6 6 2 2 2 2 2 4 2 2 2 2 2 4 2 4 2 2 4 2 8 2 2 2 2 2 2 4 2 2 2 2 1
1 4 2 4 4 2 2 2 2 2 2 2 2 2 4 2 2 2 2 2 2 4 2 2 4 2 2 2 2 4 2 2 2 4 2 2 2 2 2 1
1 4 2 2 4 2 2 2 2 2 2 2 2 2 2 4 2 2 4 2 2 2 2 2 2 2 2 4 2 2 2 2 2 2 4 2 4 4 2 1
1 2 2 2 2 2 2 4 2 2 2 2 2 2 2 2 4 2 2 2 2 2 4 2 2 4 2 2 2 2 2 2 2 2 4 2 4 4 2 1
1 1 1 1 1 1 1 1 1 1 1 1 1 1 1 1 1 1 1 1 1 1 1 1 1 1 1 1 1 1 1 2 2 2 4 2 2 4 2 1
1 2 2 2 2 2 4 2 2 3 6 6 6 2 4 2 4 2 2 6 6 6 2 2 2 2 2 3 2 4 3 2 2 2 2 2 2 2 2 1
1 2 2 3 2 2 2 2 2 4 6 6 6 2 2 2 2 2 2 6 6 6 2 2 4 4 2 4 2 2 4 2 2 2 2 4 2 2 2 1
1 2 2 2 4 2 2 4 2 4 10 6 6 2 2 2 2 2 2 6 6 9 2 2 4 2 2 4 2 2 4 2 2 2 2 2 2 2 2 1
1 2 4 2 2 2 2 2 4 2 2 2 2 2 2 2 2 4 4 4 2 2 2 2 2 2 2 4 2 2 2 2 3 2 2 2 2 4 2 1
1 2 3 2 2 2 2 2 4 2 2 2 2 2 2 2 2 4 2 4 3 2 2 3 2 2 2 2 4 2 2 2 4 2 2 3 2 2 2 1
1 2 2 4 2 2 2 2 2 2 2 2 2 2 2 2 2 2 4 2 4 2 2 4 2 2 2 2 2 2 2 2 3 2 2 2 2 2 4 1
1 2 2 2 2 2 2 2 2 1 1 1 1 1 1 1 1 1 1 1 1 1 1 1 1 1 1 1 1 1 1 1 1 1 1 1 1 1 1 1
1 2 4 2 2 2 2 2 2 2 2 2 4 2 2 2 3 2 2 2 2 4 2 2 2 2 2 4 2 2 2 4 2 2 2 2 2 2 2 1
1 2 4 2 2 2 2 2 2 2 2 2 2 4 2 2 4 2 2 2 2 2 2 2 2 4 2 2 2 2 2 2 4 2 4 4 2 2 5 1
1 2 2 2 2 4 2 2 2 2 2 2 2 2 4 2 2 2 2 2 4 2 2 2 2 2 2 2 3 2 2 2 4 2 4 4 2 2 2 1
1 2 2 2 2 4 3 2 2 4 2 2 2 2 2 2 2 2 4 2 2 2 2 2 2 4 2 4 3 2 2 2 2 2 2 4 2 2 2 1
1 2 2 2 2 2 2 4 2 2 2 2 4 2 4 4 2 2 2 2 2 2 2 2 2 4 2 4 3 2 2 2 2 2 2 2 2 2 4 1
1 2 3 2 2 2 2 2 2 2 2 2 2 2 2 2 2 2 2 2 2 2 2 2 2 4 2 2 4 2 2 2 2 4 2 2 2 4 2 1
1 1 1 1 1 1 1 1 1 1 1 1 1 1 1 1 1 1 1 1 1 1 1 1 1 1 1 1 1 1 1 1 1 1 1 1 1 1 1 1
